Date,CHINOOK,JACK,ALLCHINOOK,SCHUM,FCHUM,COHO,PINK,CISCO,BROAD,HUMPBACK,SHEEFISH,OTHER,ALLOTHER,TOTAL
5/30/2016,0,0,0,251,,0,0,570,99,171,683,140,1663,1914
5/31/2016,0,0,0,373,,0,0,848,147,254,1016,209,2474,2847
6/1/2016,526,197,723,1744,,0,0,1359,178,307,1815,286,3945,6412
6/8/2016,896,268,1164,11601,,0,0,1060,502,1429,317,1359,4667,17432
6/10/2016,871,416,1287,10071,,0,0,2002,1017,0,690,401,4110,15468
6/12/2016,3343,1357,4700,25020,,0,0,3211,89,523,341,1454,5618,35338
6/13/2016,6798,1819,8617,55122,,0,0,1252,153,110,1194,258,2967,66706
6/14/2016,3633,890,4523,34556,,0,0,722,155,111,876,260,2124,41203
6/15/2016,11097,3612,14709,72932,,0,0,395,563,441,613,0,2012,89653
6/21/2016,4842,3540,8382,115336,,0,246,1971,269,537,114,0,2891,126855
6/22/2016,5429,4469,9898,73640,,0,0,2684,286,246,1217,514,4947,88485
6/24/2016,7478,1602,9080,96668,,0,918,5062,398,1620,257,327,7664,114330
6/25/2016,5434,177,5611,69174,,0,2997,4853,687,489,151,0,6180,83962
6/26/2016,2617,124,2741,22065,,0,4852,1964,1110,237,554,530,4395,34053
6/28/2016,3315,973,4288,80949,,0,9245,3555,157,1644,107,944,6407,100889
6/29/2016,2043,548,2591,45940,,0,5172,1928,87,888,59,555,3517,57220
6/30/2016,2240,1203,3443,12864,,0,8144,4631,342,6142,45,652,11812,36263
7/1/2016,4068,1650,5718,21397,,0,11731,6517,468,9078,65,936,17064,55910
7/4/2016,2010,0,2010,91875,,0,17432,4480,151,155,214,580,5580,116897
7/5/2016,2646,0,2646,115250,,0,21005,5274,176,180,252,675,6557,145458
7/6/2016,3139,311,3450,72575,,0,23303,2948,483,1435,0,1379,6245,105573
7/7/2016,1429,121,1550,34165,,0,12432,1648,317,942,0,906,3813,51960
7/18/2016,291,0,291,1585,,0,37852,3385,446,997,99,481,5408,45136
8/14/2016,0,0,0,,15563,1308,2615,619,291,0,0,616,1526,21012
8/17/2016,0,0,0,,58800,4545,782,0,783,350,223,171,1527,65654
8/18/2016,0,0,0,,92202,6631,652,397,281,673,0,932,2283,101768
8/19/2016,0,0,0,,82501,6082,603,250,178,425,0,589,1442,90628
8/25/2016,0,0,0,,11652,22886,0,0,344,0,0,354,698,35236
8/26/2016,0,0,0,,22452,16026,0,782,236,0,0,731,1749,40227
8/27/2016,0,0,0,,16787,11953,0,552,167,0,0,515,1234,29974
8/28/2016,0,0,0,,10286,7505,0,378,114,0,0,353,845,18636
6/2/2016,1167,34,1201,1913,,0,0,2358,0,842,1540,1236,5976,9090
6/3/2016,2353,343,2696,6662,,0,0,488,0,0,1621,1068,3177,12535
6/4/2016,753,377,1130,8644,,0,0,39,0,1354,977,483,2853,12627
6/5/2016,975,11,986,16664,,0,0,40,0,0,1046,0,1086,18736
6/6/2016,1940,181,2121,18803,,0,0,1255,0,1351,1883,1145,5634,26558
6/7/2016,1289,53,1342,22653,,0,0,280,0,1406,934,989,3609,27604
6/9/2016,1785,604,2389,7999,,0,0,3056,0,0,1396,870,5322,15710
6/11/2016,3151,1481,4632,6813,,0,0,1901,0,877,1426,1540,5744,17189
6/16/2016,8180,2749,10929,108967,,0,0,1513,0,0,427,209,2149,122045
6/17/2016,5317,2060,7377,78474,,0,0,0,0,272,0,0,272,86123
6/18/2016,2073,798,2871,45536,,0,0,1527,0,342,554,816,3239,51646
6/19/2016,2540,1200,3740,20982,,0,0,2928,0,785,574,474,4761,29483
6/20/2016,5204,820,6024,54806,,0,0,1710,0,172,78,3498,5458,66288
6/23/2016,4743,3258,8001,71299,,0,2008,3510,0,1189,0,593,5292,86600
6/27/2016,7184,257,7441,20913,,0,370,8762,0,4312,165,5140,18379,47103
7/2/2016,1333,1651,2984,51820,,0,7441,4977,0,4328,379,948,10632,72877
7/3/2016,2638,160,2798,39892,,0,18226,5296,0,3753,0,565,9614,70530
7/8/2016,1148,420,1568,13333,,0,21086,392,0,1979,0,682,3053,39040
7/9/2016,699,0,699,18877,,0,15834,3609,0,1202,64,282,5157,40567
7/10/2016,1256,0,1256,37713,,0,26102,6631,0,2140,70,311,9152,74223
7/11/2016,608,229,837,17642,,0,37859,3077,0,1249,22,127,4475,60813
7/12/2016,813,369,1182,25117,,0,56209,4519,0,1755,31,182,6487,88995
7/13/2016,840,498,1338,67918,,0,69188,5559,0,2052,0,1240,8851,147295
7/14/2016,655,546,1201,51605,,0,65729,5580,0,1806,0,1034,8420,126955
7/15/2016,1273,0,1273,16217,,0,67799,410,0,0,0,570,980,86269
7/16/2016,130,97,227,11122,,0,49203,7810,0,1796,223,285,10114,70666
7/17/2016,152,79,231,14211,,0,63508,10510,0,2473,235,233,13451,91401
7/19/2016,72,0,72,,36612,0,33730,3129,0,266,0,181,3576,73990
7/20/2016,158,0,158,,57077,0,55810,5235,0,387,0,395,6017,119062
8/24/2016,439,0,439,,31810,21429,0,0,0,0,0,210,210,53888
7/21/2016,0,0,0,,76285,0,102347,2024,0,0,0,0,2024,180656
7/22/2016,0,0,0,,70337,0,76875,5190,0,621,0,442,6253,153465
7/23/2016,0,0,0,,33851,0,66277,1476,0,438,0,239,2153,102281
7/24/2016,0,0,0,,22347,0,42224,1274,0,477,0,261,2012,66583
7/26/2016,0,0,0,,20652,0,31645,1983,0,93,513,0,2589,54886
7/27/2016,0,0,0,,17029,0,25554,1443,0,101,374,0,1918,44501
7/28/2016,0,0,0,,10853,0,26897,204,0,0,107,0,311,38061
7/29/2016,0,0,0,,3743,0,21790,2096,0,0,0,0,2096,27629
7/30/2016,0,0,0,,1497,0,22241,943,0,0,0,382,1325,25063
7/31/2016,0,0,0,,2384,0,30998,1203,0,0,0,611,1814,35196
8/1/2016,0,0,0,,8081,0,22281,1039,0,0,0,439,1478,31840
8/2/2016,0,0,0,,19832,356,14470,788,0,0,0,191,979,35637
8/3/2016,0,0,0,,17580,326,12836,540,0,0,0,254,794,31536
8/5/2016,0,0,0,,10514,521,10271,494,0,0,0,1007,1501,22807
8/7/2016,0,0,0,,2823,654,5311,1744,0,176,0,951,2871,11659
8/8/2016,0,0,0,,4240,1096,9294,3015,0,191,0,1256,4462,19092
8/22/2016,0,0,0,,17165,3753,203,200,0,246,101,112,659,21780
8/23/2016,0,0,0,,43383,9156,610,367,0,624,185,205,1381,54530
8/4/2016,0,0,0,,16585,696,11212,0,0,176,0,1396,1572,30065
8/6/2016,0,0,0,,5274,542,9372,0,0,274,0,326,600,15788
8/9/2016,0,0,0,,5242,2697,7051,0,0,521,0,103,624,15614
8/10/2016,0,0,0,,3862,1692,4715,0,0,433,0,86,519,10788
8/11/2016,0,183,183,,1708,2290,3720,0,0,0,234,225,459,8360
8/12/2016,0,58,58,,4624,1895,2314,0,0,156,131,0,287,9178
8/13/2016,0,92,92,,7646,3140,3783,0,0,245,205,0,450,15111
8/15/2016,0,0,0,,23385,2827,1013,0,0,1370,297,519,2186,29411
8/16/2016,0,0,0,,29986,3571,1565,0,0,1457,508,489,2454,37576
8/20/2016,0,0,0,,36839,10203,314,0,0,308,0,0,308,47664
8/21/2016,0,0,0,,15666,5160,217,0,0,213,0,0,213,21256
8/29/2016,0,0,0,,3128,10192,0,0,0,237,0,168,405,13725
8/30/2016,0,0,0,,2834,4421,0,0,0,643,216,186,1045,8300
8/31/2016,0,0,0,,2423,4744,0,0,0,483,341,295,1119,8286
7/25/2016,0,0,0,,17220,0,47366,0,0,0,0,0,0,64586
