Date,CHINOOK,JACK,ALLCHINOOK,SCHUM,FCHUM,COHO,PINK,CISCO,BROAD,HUMPBACK,SHEEFISH,OTHER,ALLOTHER,TOTAL
6/1/2010,0,0,0,0,,0,0,648,27,85,585,220,1565,1565
6/2/2010,0,0,0,0,,0,0,3033,281,1267,3648,610,8839,8839
6/3/2010,0,0,0,0,,0,0,2259,186,949,2741,462,6597,6597
6/4/2010,0,0,0,0,,0,0,2738,257,1179,3331,534,8039,8039
6/5/2010,0,0,0,0,,0,0,3173,311,1385,3874,606,9349,9349
6/6/2010,0,0,0,0,,0,0,2566,251,1062,3065,515,7459,7459
6/7/2010,0,0,0,0,,0,0,2064,193,910,2536,395,6098,6098
6/8/2010,0,0,0,0,,0,0,2435,248,1075,2980,457,7195,7195
6/9/2010,0,0,0,0,,0,0,275,435,637,2800,1392,5539,5539
6/10/2010,0,0,0,0,,0,0,2302,101,108,2188,1830,6529,6529
6/11/2010,0,0,0,0,,0,0,550,0,1762,1798,1101,5211,5211
6/12/2010,41,0,41,1602,,0,0,1501,235,213,2591,225,4765,6408
6/13/2010,158,463,621,1147,,0,0,460,0,375,1648,1029,3512,5280
6/14/2010,368,0,368,340,,0,0,98,0,76,2916,660,3750,4458
6/15/2010,892,41,933,1714,,0,0,407,78,55,1710,574,2824,5471
6/16/2010,1094,454,1548,3642,,0,0,271,98,68,488,107,1032,6222
6/17/2010,1943,102,2045,18432,,0,0,179,0,0,201,284,664,21141
6/18/2010,1911,639,2550,41646,,0,0,0,0,0,0,181,181,44377
6/19/2010,11655,692,12347,48346,,0,0,1480,0,258,314,873,2925,63618
6/20/2010,4328,336,4664,76492,,0,0,1398,0,663,616,741,3418,84574
6/21/2010,3273,495,3768,83429,,0,1352,1146,0,112,0,1216,2474,91023
6/22/2010,8820,459,9279,77793,,0,1510,3490,0,0,64,876,4430,93012
6/23/2010,4495,632,5127,68402,,0,923,265,0,0,167,136,568,75020
6/24/2010,3134,671,3805,74662,,0,379,462,0,0,917,887,2266,81112
6/25/2010,5837,2285,8122,48334,,0,5626,4004,0,0,802,1183,5989,68071
6/26/2010,8349,2058,10407,68765,,0,7508,457,0,0,399,1263,2119,88799
6/27/2010,6995,1571,8566,58709,,0,8837,3157,209,218,664,637,4885,80997
6/28/2010,5478,604,6082,69910,,0,3415,0,0,1079,249,3160,4488,83895
6/29/2010,12953,4844,17797,163556,,0,16286,6304,0,0,415,721,7440,205079
6/30/2010,9460,211,9671,137708,,0,11142,0,0,0,0,1793,1793,160314
7/1/2010,1923,1957,3880,63076,,0,6186,0,0,0,280,2254,2534,75676
7/2/2010,2753,1115,3868,22001,,0,17542,299,333,0,0,293,925,44336
7/3/2010,1887,119,2006,26043,,0,13158,933,147,658,0,441,2179,43386
7/4/2010,2065,0,2065,20791,,0,17939,453,0,320,425,1539,2737,43532
7/5/2010,1593,1060,2653,18950,,0,11531,0,186,0,581,160,927,34061
7/6/2010,1494,1340,2834,23179,,0,16762,435,0,241,0,44,720,43495
7/7/2010,1250,0,1250,24774,,0,19325,2724,118,650,0,715,4207,49556
7/8/2010,728,731,1459,36576,,0,28859,1324,0,0,0,393,1717,68611
7/9/2010,1747,226,1973,46375,,0,26280,6105,0,2004,0,838,8947,83575
7/10/2010,700,135,835,20339,,0,14417,3171,0,1000,0,505,4676,40267
7/11/2010,403,229,632,7237,,0,19116,7556,0,1850,437,144,9987,36972
7/12/2010,413,259,672,7439,,0,20277,8183,0,2057,463,124,10827,39215
7/13/2010,742,0,742,12367,,0,25516,3725,170,1652,24,0,5571,44196
7/14/2010,986,0,986,17077,,0,33553,5122,230,2116,42,0,7510,59126
7/15/2010,1034,533,1567,13323,,0,62754,4870,1217,449,0,177,6713,84357
7/16/2010,807,422,1229,11365,,0,66232,5290,1339,342,0,160,7131,85957
7/17/2010,494,522,1016,3359,,0,57791,6473,639,3176,0,0,10288,72454
7/18/2010,0,0,0,4472,,0,64390,8130,0,1541,0,0,9671,78533
7/19/2010,0,0,0,,28445,0,35120,6786,0,4678,552,56,12072,75637
7/20/2010,54,50,104,,31090,0,51790,3068,910,2072,0,0,6050,89034
7/21/2010,0,0,0,,18504,0,51431,7924,486,3074,0,0,11484,81419
7/22/2010,69,39,108,,10525,0,30752,10630,439,4713,0,49,15831,57216
7/23/2010,0,0,0,,10953,0,25775,4846,0,5798,501,0,11145,47873
7/24/2010,57,0,57,,4191,0,30167,4155,46,2706,0,77,6984,41399
7/25/2010,0,0,0,,3233,0,26032,1373,209,4585,23,96,6286,35551
7/26/2010,0,0,0,,13336,0,10319,4091,0,4397,398,574,9460,33115
7/27/2010,0,0,0,,3335,0,11829,153,0,6342,0,113,6608,21772
7/28/2010,0,0,0,,2587,92,11167,2064,0,3310,264,94,5732,19578
7/29/2010,0,0,0,,742,204,13370,2210,300,4705,559,0,7774,22090
7/30/2010,0,0,0,,741,0,9873,1802,775,6703,240,337,9857,20471
7/31/2010,0,0,0,,7288,0,8095,1928,695,3846,0,319,6788,22171
8/1/2010,0,0,0,,4356,0,5526,615,0,8656,0,346,9617,19499
8/2/2010,0,0,0,,1063,531,4181,3897,309,4752,0,241,9199,14974
8/3/2010,0,0,0,,769,663,3219,1925,764,5771,99,327,8886,13537
8/4/2010,0,0,0,,2759,253,2783,1022,557,4937,56,390,6962,12757
8/5/2010,0,0,0,,4593,113,3153,4060,71,5321,0,125,9577,17436
8/6/2010,0,0,0,,2406,472,2027,5432,176,8398,0,537,14543,19448
8/7/2010,0,0,0,,1127,731,176,8930,766,5034,0,305,15035,17069
8/8/2010,0,0,0,,22457,212,1452,11065,0,1583,0,145,12793,36914
8/9/2010,0,0,0,,12426,1495,257,18579,0,3165,0,893,22637,36815
8/10/2010,0,0,0,,4501,3454,0,6660,684,2953,0,359,10656,18611
8/11/2010,0,0,0,,2975,2612,0,5059,305,7054,0,369,12787,18374
8/12/2010,0,0,0,,31496,1368,697,3917,349,3676,352,156,8450,42011
8/13/2010,0,0,0,,22742,3371,0,3486,50,1890,42,0,5468,31581
8/14/2010,0,0,0,,3315,2135,54,3916,32,961,121,238,5268,10772
8/15/2010,0,0,0,,2212,5188,54,1589,32,1605,0,590,3816,11270
8/16/2010,0,0,0,,522,5242,0,784,46,1994,0,0,2824,8588
8/17/2010,0,0,0,,137,1030,0,309,833,3615,0,183,4940,6107
8/18/2010,0,0,0,,41355,2781,0,2702,0,979,0,0,3681,47817
8/19/2010,0,0,0,,65775,8801,0,2075,0,0,0,210,2285,76861
8/20/2010,0,0,0,,23639,14743,0,265,0,750,0,178,1193,39575
8/21/2010,0,0,0,,7871,9729,0,1267,0,996,0,0,2263,19863
8/22/2010,0,0,0,,2956,6781,0,756,0,1169,0,165,2090,11827
8/23/2010,0,0,0,,1570,7252,0,2822,0,863,0,328,4013,12835
8/24/2010,0,0,0,,2689,7097,0,1674,81,506,0,0,2261,12047
8/25/2010,0,0,0,,4617,5407,0,2850,498,639,0,88,4075,14099
8/26/2010,0,0,0,,7831,5953,0,1075,341,1255,0,0,2671,16455
8/27/2010,0,0,0,,4094,6388,0,2854,402,1200,0,0,4456,14938
8/28/2010,0,0,0,,1672,4506,0,2538,212,778,0,124,3652,9830
8/29/2010,0,0,0,,1092,4396,0,1232,338,973,0,0,2543,8031
8/30/2010,0,0,0,,496,2844,0,3874,327,515,84,127,4927,8267
8/31/2010,0,0,0,,3734,2891,0,2477,379,1712,0,0,4568,11193
9/1/2010,0,0,0,,4292,9955,657,1103,122,473,0,69,1767,16671
9/2/2010,0,0,0,,3640,8938,474,1139,125,488,0,72,1824,14876
9/3/2010,0,0,0,,14185,7023,0,907,227,964,0,0,2098,23306
9/4/2010,0,0,0,,5906,8077,0,1725,129,408,0,78,2340,16323
9/5/2010,222,0,222,,3019,11385,0,268,204,288,0,0,760,15386
9/6/2010,0,0,0,,1813,6733,0,2113,327,410,0,68,2918,11464
9/7/2010,0,0,0,,1031,6878,0,1550,0,497,0,283,2330,10239
