Date,CHINOOK,JACK,ALLCHINOOK,SCHUM,FCHUM,COHO,PINK,CISCO,BROAD,HUMPBACK,SHEEFISH,OTHER,ALLOTHER,TOTAL
6/1/2012,0,0,0,0,,0,0,2191,68,101,2936,0,5296,5296
6/2/2012,0,0,0,0,,0,0,1793,31,46,2309,0,4179,4179
6/3/2012,0,0,0,0,,0,0,2434,0,0,1391,95,3920,3920
6/4/2012,0,0,0,0,,0,0,753,0,0,2360,0,3113,3113
6/5/2012,0,0,0,0,,0,0,2040,0,0,1518,77,3635,3635
6/6/2012,0,0,0,0,,0,0,2249,0,0,1054,83,3386,3386
6/7/2012,0,0,0,0,,0,0,1747,0,0,855,72,2674,2674
6/8/2012,0,0,0,0,,0,0,1366,0,0,642,76,2084,2084
6/9/2012,0,0,0,0,,0,0,1557,0,0,725,78,2360,2360
6/10/2012,70,0,70,0,,0,0,1353,0,0,694,99,2146,2216
6/11/2012,100,0,100,0,,0,0,1195,0,0,592,768,2555,2655
6/12/2012,0,0,0,911,,0,0,81,0,0,483,989,1553,2464
6/13/2012,474,0,474,1895,,0,0,104,0,0,614,0,718,3087
6/14/2012,154,0,154,1397,,0,0,125,407,0,802,0,1334,2885
6/15/2012,39,0,39,1036,,0,0,0,282,0,1034,0,1316,2391
6/16/2012,1871,78,1949,10825,,0,0,0,0,0,446,52,498,13272
6/17/2012,914,494,1408,45295,,0,0,0,384,0,297,0,681,47384
6/18/2012,723,179,902,42791,,0,0,630,0,0,330,0,960,44653
6/19/2012,1082,432,1514,56471,,0,0,232,262,266,795,486,2041,60026
6/20/2012,2139,742,2881,73920,,0,0,1655,0,0,349,0,2004,78805
6/21/2012,2294,277,2571,71724,,0,378,800,0,0,1068,0,1868,76541
6/22/2012,2260,1280,3540,99523,,0,0,0,0,0,339,0,339,103402
6/23/2012,6787,876,7663,113552,,0,0,0,0,0,740,359,1099,122314
6/24/2012,7679,1054,8733,98203,,0,0,0,0,0,1136,0,1136,108072
6/25/2012,3211,1798,5009,74775,,0,2057,0,0,0,1442,0,1442,83283
6/26/2012,8169,2690,10859,70742,,0,1257,833,736,0,1088,0,2657,85515
6/27/2012,7584,1619,9203,92873,,0,2476,0,0,0,219,438,657,105209
6/28/2012,16288,1758,18046,151906,,0,4436,0,0,0,0,0,0,174388
6/29/2012,5542,2087,7629,152437,,0,4911,2311,0,0,236,0,2547,167524
6/30/2012,4510,0,4510,106651,,0,3701,388,0,0,274,0,662,115524
7/1/2012,1899,446,2345,90443,,0,4783,2242,0,0,0,0,2242,99813
7/2/2012,4789,1258,6047,70866,,0,6411,686,0,0,0,0,686,84010
7/3/2012,1930,521,2451,59364,,0,28466,560,0,0,193,0,753,91034
7/4/2012,1531,481,2012,49830,,0,9881,0,0,0,580,469,1049,62772
7/5/2012,1837,0,1837,60730,,0,28972,722,242,292,211,1161,2628,94167
7/6/2012,6228,1042,7270,124537,,0,13187,510,0,482,166,0,1158,146152
7/7/2012,2501,217,2718,69896,,0,35182,4647,282,329,364,0,5622,113418
7/8/2012,2276,0,2276,44583,,0,16563,2218,429,0,217,187,3051,66473
7/9/2012,581,727,1308,52659,,0,7167,4436,0,349,238,0,5023,66157
7/10/2012,3302,0,3302,50930,,0,10696,2197,0,254,295,266,3012,67940
7/11/2012,265,0,265,62718,,0,21572,2626,0,663,0,462,3751,88306
7/12/2012,1049,0,1049,45793,,0,9727,1662,0,0,393,0,2055,58624
7/13/2012,1062,0,1062,26515,,0,12380,2648,0,167,0,0,2815,42772
7/14/2012,1234,104,1338,16764,,0,12519,4753,0,0,106,180,5039,35660
7/15/2012,980,89,1069,13319,,0,10110,3813,0,0,91,155,4059,28557
7/16/2012,74,0,74,6986,,0,12007,1842,0,0,222,458,2522,21589
7/17/2012,369,501,870,14685,,0,10916,1565,0,0,114,130,1809,28280
7/18/2012,298,276,574,8931,,0,8582,994,0,0,63,121,1178,19265
7/19/2012,284,0,284,,21878,0,6225,1090,0,1640,152,0,2882,31269
7/20/2012,403,0,403,,45859,0,15332,3140,0,1061,0,0,4201,65795
7/21/2012,571,0,571,,29279,314,12094,3997,0,880,298,531,5706,47964
7/22/2012,427,0,427,,21429,240,8554,2971,0,608,220,387,4186,34836
7/23/2012,459,0,459,,7438,0,11630,3934,0,1745,1074,182,6935,26462
7/24/2012,0,0,0,,7322,29,6625,3898,0,1557,0,0,5455,19431
7/25/2012,0,0,0,,5992,0,5143,1977,26,2468,20,0,4491,15626
7/26/2012,0,0,0,,7450,0,6626,2396,41,3014,33,0,5484,19560
7/27/2012,112,0,112,,14788,0,6661,1282,0,4978,432,0,6692,28253
7/28/2012,0,0,0,,39835,384,10905,2084,0,3824,0,68,5976,57100
7/29/2012,105,0,105,,41382,595,14279,2354,395,3262,0,220,6231,62592
7/30/2012,73,0,73,,23404,345,7898,1284,203,1732,0,153,3372,35092
7/31/2012,0,0,0,,10780,500,6611,1717,915,7308,0,109,10049,27940
8/1/2012,0,0,0,,7783,351,5156,1290,668,5238,0,91,7287,20577
8/2/2012,0,0,0,,11676,277,6162,1569,389,10321,0,185,12464,30579
8/3/2012,0,0,0,,36807,1290,2264,1348,0,4123,203,0,5674,46035
8/4/2012,0,0,0,,15518,1184,3024,4747,175,5663,95,103,10783,30509
8/5/2012,0,0,0,,8814,711,2076,2971,148,3557,53,88,6817,18418
8/6/2012,0,0,0,,6900,1160,847,4246,670,2884,79,0,7879,16786
8/7/2012,0,0,0,,9351,1637,1118,5958,756,3250,160,0,10124,22230
8/8/2012,0,0,0,,14708,794,349,3366,543,6599,0,264,10772,26623
8/9/2012,0,0,0,,4856,856,849,1993,1630,6459,0,262,10344,16905
8/10/2012,0,0,0,,4571,2191,836,5692,0,2415,0,0,8107,15705
8/11/2012,0,0,0,,3328,1687,0,2929,0,9928,218,532,13607,18622
8/12/2012,0,0,0,,2457,1402,563,1904,0,10692,0,799,13395,17817
8/13/2012,0,0,0,,1533,2878,69,3471,1448,9086,0,481,14486,18966
8/14/2012,0,0,0,,753,820,111,3785,421,11565,0,903,16674,18358
8/15/2012,0,0,0,,3941,8136,0,2290,122,4261,0,614,7287,19364
8/16/2012,0,0,0,,3221,1927,0,1931,357,7897,0,360,10545,15693
8/17/2012,0,0,0,,1818,4450,0,2556,507,3713,0,0,6776,13044
8/18/2012,0,0,0,,55809,2210,0,3649,89,1651,0,78,5467,63486
8/19/2012,0,0,0,,103248,4547,0,7396,187,2981,0,164,10728,118523
8/20/2012,0,0,0,,82597,8510,0,2223,629,8895,0,330,12077,103184
8/21/2012,0,0,0,,34056,16293,0,6404,403,4002,71,124,11004,61353
8/22/2012,0,0,0,,16481,8448,0,3614,230,2461,69,122,6496,31425
8/23/2012,0,0,0,,9163,4507,0,3720,0,3723,48,0,7491,21161
8/24/2012,0,0,0,,6857,4751,0,4187,0,1008,0,54,5249,16857
8/25/2012,0,0,0,,7259,4560,0,0,0,4562,0,138,4700,16519
8/26/2012,0,0,0,,4104,1693,0,3292,229,1936,0,440,5897,11694
8/27/2012,0,0,0,,4448,1725,0,3084,211,1879,0,417,5591,11764
8/28/2012,0,0,0,,3083,5518,0,3108,785,1979,0,197,6069,14670
8/29/2012,0,0,0,,2618,4456,0,1994,459,1375,0,120,3948,11022
8/30/2012,0,0,0,,2697,2325,0,2182,386,1890,0,79,4537,9559
8/31/2012,0,0,0,,6587,1203,0,1286,0,357,0,200,1843,9633
9/1/2012,0,0,0,,2238,2568,0,811,272,2980,0,893,4956,9762
9/2/2012,0,0,0,,4079,1652,0,2756,124,950,0,239,4069,9800
9/3/2012,0,0,0,,4415,3357,0,911,61,841,0,116,1929,9701
9/4/2012,0,0,0,,3386,4162,0,1402,212,1240,0,217,3071,10619
9/5/2012,0,0,0,,3141,4602,0,2706,0,512,0,0,3218,10961
9/6/2012,0,0,0,,4298,4846,0,753,0,154,0,287,1194,10338
9/7/2012,0,0,0,,2723,4643,0,724,0,1679,0,128,2531,9897
